5 11
# # . . . # . . . # #
. . . # . . . # . . #
# # . # # # . # # # #
# . . # # . . # # R #
# # . . C # . . . . #
